111111111111111111111111111111111111111111
000000000010000000000000000000000000000000
000000000010000000000000000000000000000000
000000000010000000000000000000000000000000
000000000011111111111100000000000000100000
000000000010000000000000000000000003100000
000000000010000000000000000000000003100000
000000000010000000000000000000000003100000
000000000010000000000000000000000003100000
000000000010000001111111111111111111100000
000000000010000000000000000000000000100000
000000000010000000000000000000000000100000
000000000010000000000000000000000000100000
000000000010000000000000000000000000100000
000000000011111111111111110000000000100000
000000000000000000000000000000000003100000
000000000000000000000000000000000003100000
000000000000000000000000000000000003100000
000000000000000000000000000000000003100000
111111111111111111111111111111111111111111
111111111111111111111111111111111111111111
000000000001000000000000111111111111000000
000000000001000000000000011111111111000000
000000000000100000000000000011111110000000
000000000000310000000000000001100000000000
000000000000310000000000000000000000000000
000000000000100000000000000000000000000000
000000000000000200000000000000000000020000
000000000000200000000000000000000000000000
000000002000000000000000000000000000000000
000000000000200000000000000000000000000000
000000000000000200000000000000000000002000
000000000000000000000000000000000000000000
000031111000000000000000000000000310000000
000311111100000000000000000000001100000000
000111110010000000000000000000001100000000
000111111100000000000100000000001100000000
000011111100000000000110000000011111000000
000010000100000000001110000001111111000000
111111111111111111111111111111111111111111
111111111111111111111111111111111111111111
000000100100000000000000000000000000000000
000000010100000000000000000202002000000000
000000001000000000000000000000000000000000
000000011100000000000000000202002000000000
000000031100000000000000000000000000000000
000000011100000000000000000200002000000000
000000000000000000000000000000000000000000
000000000000000000000000000000000000000000
000000000000000000000000000000000000000000
000000000000000000000000000000000000000000
000000000000000000000110000000000000000000
000000000000000000031111000000000000000000
000000000000000000011111100000000000000000
100000000000000000011111100000000000000000
110000000000000000000110000000000000000000
111000000000000000000111000000000000000000
111100000000000000000110000000000000000000
111110000000000000000110000000000000000000
111111111111111111111111111111111111111111
111111111111111111111111111111111111111111
000000000000000000000000000000000000000000
000200000000000000000000000000000000000000
000000000000000000000000000202020202000000
000200000000000000000000000000000000000000
000000000000000000000000000000000020000000
000200000000000000000000000000000000000000
000000000000000000000000000000000020000000
000000000000000000000000000000000000000000
000000000000000111111000000000000020000000
000000000000000311111000000000000000000000
000000000000001111111100000000000020000000
000000000000011111111111100000000000000000
000000000000111111111111110000000000000000
000000000031111111111111111000000000000000
000200000311111111111111111100000000000000
000000003111111111111111111110000000000000
000200311111111111111111111111100000000000
000003111111111111111111111111111000000000
111111111111111111111111111111111111111111
111111111111111111111111111111111111111111
000000001000000000000100000000100000000000
000000001000000000000100000000100000000000
000000031000000000000310000000100000000000
000000001000000000000010000000310000000000
000000010000000000000100000000010000000000
000003100000000000000100000000310000000000
000011000000000000000310000000000000000000
000000000000020000000000000000000000000000
000000000000020000000000002000000000000000
000000000000020000002000000000000000000000
000000000000000000200002000000000000000000
000000000000020000002000000000000000000000
000000000000020000000000000000000000000000
000000000000000000002000020000000000000000
000200000000000000000002000000000000000000
000002000000000000000000000000000000000000
000003100000200000000003100000000000000000
000311100000000000000311100000000000000000
111111111111111111111111111111111111111111
111111111111111111111111111111111111111111
001110000000000000000000000000000000000111
001010000000000000000000000000000000000111
001110000000000000000000000000000000000111
001010000000000000000000000000000000000111
001010000000000000000000000000000000000111
001110000000000000000000000000000000000111
001010000000000000000000000000000000000111
001110000000000000000000000000000000000111
000000000000000000000000000000000000000111
000000000000000000000000000000000000000111
000000000000000000000000000000000000000111
001110000000000000000000000000000000000111
001010000000000000000000000000000000000111
001110000000000000000000000000000000000111
001010000000000000000000000000000000000111
001010000000000000000000000000000000000111
001110000000000000000000000000000000000111
001010000000000000000000000000000000000111
111111111111111111111111111111111111111111
