011111111111111111111111111111111111111111
011111111111111111111111111111111111111111
011111111111111111111111111111111111111111
010000000000000011000000000000110000000000
010000000000000011000000000000110000000000
010000000000000011000000000000110000000000
010000000000000011000111111000110001111000
010000000000000011000001100000110000011000
010000000000000011000001100000110000011000
010000000000000011000001100000110000011000
010000000000000011000001100000110000011000
010000000000000011110001100011111100011000
010000000000000000000001100000000000011000
010000000000000000000001100000000000011000
010000000000000000000001100000000000011000
011111111111111111111111111111111111111111
011100001001101101011010000111100100111111
011110110110101101011010110111011011011111
011111010000100001011010001111100100111111
011100000110101101100110110111111011111111
111111111111111111111111111111111111111111
000000000000000000000111110000000000110000
000000000000000000000111110000000000110000
000000000000000000000111110000000000110000
000000000000000000000000000000000000110000
000000000000000000000000000000000000110000
000000000000000000000000000000000000031000
000000000000000000000000002000000000000000
000000000000000000000000000000000000000000
00000000000000000000000000000000000000000
000000000000000000000000000000000000000000
000000000000000000000000002000000000000000
000000000000000000000000000000000000000000
000000000000000000000000000000000000031000
000000000000000000000000000000000000110000
000000000000000000000000000000000000110000
000000000000000000000111110000000000110000
000000000000000000000111110000000000110000
000000000000000000000111110000000000110000
111111111111111111111111111111111111111111
111111111111111111111111111111111111111111
000000000000000000310000000000310000000000
000000000200000000000000000000000000000000
000000000000000000000011100000000000000000
000000000200000000001111111111111000000000
000000000000000000000000000311100000000000
000000000200000000000000000000000000000000
000000000000000000000000000000000000002000
000000000200000000000000000000000000000000
000000000000000000000000000000000000000000
000000000000000000000000000000000000000000
000000000000000000000000000000000000002000
000000000000000000000000000000000000000000
000000000200000000000000031100000000000000
000000000000000000000111111111111100000000
000000000200000000000000001100000000000000
000000000000000000000000000000000000000000
000000000200000000000000000000000000000000
000000000000000000031000000000031000000000
111111111111111111111111111111111111111111
111111111111111111111111111111111111111111
101000000000000000000000000000000000000111
111000000000000000000000000000000000000111
101000000000000000000000000000000000000111
111000000000000000000000000000000000000111
101000000000000000000000000000000000000111
111000000000000000000000000000000000000111
000000000000000000000000000000000000000111
000000000000000000000000000000000000000111
000000000000000000000000000000000000000111
000000000000000000000000000000000000000111
000000000000000000000000000000000000000111
000000000000000000000000000000000000000111
111000000000000000000000000000000000000111
101000000000000000000000000000000000000111
111000000000000000000000000000000000000111
101000000000000000000000000000000000000111
111000000000000000000000000000000000000111
101000000000000000000000000000000000000111
111111111111111111111111111111111111111111
