111111111111111111111111111111111111111111
100000000000000000000111110000000000110000
100000000000000000000111110000000000110000
100000000000000000000111110000000000110000
100000000000000000000000000000000000110000
100000000000000000000000000000000000110000
100000000000000000000000000000000000031000
100000000000000000000000002000000000000000
100000000000000000000000000000000000000000
100000000000000000000000000000000000000000
100000000000000000000000000000000000000000
100000000000000000000000002000000000000000
100000000000000000000000000000000000000000
100000000000000000000000000000000000031000
100000000000000000000000000000000000110000
100000000000000000000000000000000000110000
100000000000000000000111110000000000110000
100000000000000000000111110000000000110000
100000000000000000000111110000000000110000
111111111111111111111111111111111111111111
111111111111111111111111111111111111111111
000000000000000000310000000000310000000000
000000000200000000000000000000000000000000
000000000000000000000011100000000000000000
000000000200000000001111111111111000000000
000000000000000000000000000311100000000000
000000000200000000000000000000000000000000
000000000000000000000000000000000000002000
000000000200000000000000000000000000000000
000000000000000000000000000000000000000000
000000000000000000000000000000000000000000
000000000000000000000000000000000000002000
000000000000000000000000000000000000000000
000000000200000000000000031100000000000000
000000000000000000000111111111111100000000
000000000200000000000000001100000000000000
000000000000000000000000000000000000000000
000000000200000000000000000000000000000000
000000000000000000031000000000031000000000
111111111111111111111111111111111111111111
111111111111111111111111111111111111111111
101000000000000000000000000000000000000111
111000000000000000000000000000000000000111
101000000000000000000000000000000000000111
111000000000000000000000000000000000000111
101000000000000000000000000000000000000111
111000000000000000000000000000000000000111
000000000000000000000000000000000000000111
000000000000000000000000000000000000000111
000000000000000000000000000000000000000111
000000000000000000000000000000000000000111
000000000000000000000000000000000000000111
000000000000000000000000000000000000000111
111000000000000000000000000000000000000111
101000000000000000000000000000000000000111
111000000000000000000000000000000000000111
101000000000000000000000000000000000000111
111000000000000000000000000000000000000111
101000000000000000000000000000000000000111
111111111111111111111111111111111111111111
